#########################################
#   # #           #                     #
### # # ##### ### ######### ########### #
# # # # #   # # #         # #         # #
# # # # # # # # ######### # # ####### # #
# # #   # # # #       #   # # #       # #
# # # ### ### ### ##### ### # # ####### #
# # # #     # #   #     # #   # #     # #
# # # # ### # # # # ##### ##### # ##### #
# # # # # # # # # # #         # # #   # #
# # # # # # # # ### ### ### ### # # # # #
# # # #   # # #       #   #   # #   # # #
# # # ##### # ####### ### ### # ##### # #
# # # #     #       #   # #   #       # #
# # # # ### ####### ### ### ### ####### #
# # # # # # #     # # #   #     #       #
# # # # # # ##### # # ### ##### # ##### #
#   #   #         # #   # #   # # #   # #
# ### ############# # # # # # # # # # # #
# # # #             # # #   # # # # # # #
# # # # ############# ####### # # # ### #
# #   # #   #               # # # #   # #
# ##### # # # ############# # # # # # # #
#       # # # #           # # # # # # # #
######### # # # ####### # # # ### # # # #
#         # # #       # # # #   # # # # #
# # ######### ######### # # ### # # # # #
# # #       # #         # #   # # # #   #
# # # ##### # # ######### ### # # ### ###
# # #     # # # # #     # # # # #   # # #
# ### ##### # # # # ### # # # # # # # # #
#     #     # # # #   # # # # # # # # # #
# ##### ### # # # ### # # # # # ### # # #
#     # #   # # #   # # # # # # #   #   #
####### ##### # # ### # # # # # # ##### #
#       #     # #     #   # # # #   # # #
# ##### # ##### ####### ### # # # # # # #
# #     # #           # #   # # # # # # #
# ####### ########### # ### # # ### # # #
#                     #     #       #   #
#########################################
