#########################################
# #                               #     #
# ### ########### ### ############# ### #
#   #     #     # # #                 # #
### # ##### ### # # ################### #
# # # #   # # # #   #                 # #
# # # # # # # # ### # ############### # #
#   # # # # #     # #               #   #
# ##### # # ##### ##### ########### ### #
#       # #     #     # # #       # # # #
######### # ### ##### # # # # ##### # # #
#     #   # # # #   # # #   #     # # # #
# ### # ### # # ### # # ######### # # # #
#   # # # # # # #   # #           # #   #
### # # # # # # # # # ############# # ###
#   # # # # # # # # #               # # #
##### # # # # # # ################### # #
#     # # # # # #                     # #
# ### # # # # # ################### ### #
# #   # # # # #                   # #   #
# ##### # # # ########### ####### # # ###
#     # # # #   #       # #     # # #   #
# ### # # # ### # ##### # ##### # # ### #
#   # # # #     # #   # #       # #     #
##### # # ##### # # # # ####### # #######
#     # #       # # # #   #     #       #
# ### # ####### # # ##### ############# #
# # # #       # # #     # #             #
# # # ####### # # # ### # # ##### #######
# #   #       # # #   # # # #     #     #
# # ### ######### # ### # # # ##### ### #
# # #   #         # #   # # #     # # # #
# # # ##### ######### # # # ####### # # #
# # # #   # #   #     # # #         # # #
# # # # # # # # # ##### # # ######### # #
# # # # #   # # #     # # # #         # #
# # # # ##### # # ### ### # ####### # # #
# # # #       # #   # #   #         # # #
# ### ######### ### # # ############### #
#               #   #                   #
#########################################
