#########################################
#         #     #           #           #
######### # # # ######### # # # ####### #
#         # # #           # # # #     # #
# ########### ############# ### # ### # #
# #           #       #   #   # # # # # #
# ### ######### # ### # # ### # # # # # #
#     #       # # # # # #   # # # # # # #
####### ##### # # # # # ### # # # # # # #
#     # #   #   # #   # # # # # # # #   #
# ##### # ####### ##### # # # # # # #####
#     #   #       #     # # # # #       #
# ### ### # ##### # ##### # # # ####### #
# # #     # #     #       #   # #     # #
# # ####### ############# ##### # ### # #
# #       #             #     # #   # # #
# ####### ########### # ##### # ##### # #
# #                 # # #   # # #     # #
# # ############### # # ### # # # ### # #
# #     # #         # #     #   # #   # #
# ##### # # ######### ########### ##### #
#       #           #   #             # #
################### ### # ########### # #
#               #     # #           # # #
# ############# ##### # # ######### # # #
#     #           #   # # #   #     # # #
# ### # ######### ##### # # # ####### # #
# # # #   #     #       # # #       # # #
# # # ##### ### ####### # # ####### # # #
# # #     # # # #       # # #     #   # #
# # ##### # # # # ####### # # ##### ### #
# #     # #   # #       # # #       #   #
# ##### # ### # ####### # # ### ##### ###
#       #   # # #   #   # #   #     # # #
####### ### # # # # # ### ### ##### # # #
#     # # #   # # # #   # # #     # # # #
# ### # # ##### # # # ### # ##### ### # #
# #   # #   #   # # # #   #   #   #   # #
# ##### # # # ### # ### ### # # ### ### #
#         # #     #         # #         #
#########################################
